#########
# O     #
#   X  O#
# X     #
#    X P#
#O X    #
#     O #
#########
